i:	iy	ih	beat
I	ih	ih	bit
E	eh	eh	bet
@	ae	ah	bat
A	aa	aa	bob
^	ah	ah	but
>	ao	ao	bought
U	uh	w	book
u	uw	w	boot
ux	ux	w	suit
&	ax	aw	about
3r	er	er	bird
&r	axr	ah	butter
ei	ey	eh	bait
>i	oy	oy	boy
aI	ay	ay	buy
aU	aw	aw	down
oU	ow	ow	show			
j	j	sh	you
w	w	w	wit
9	r	r	rent
9r	NA	r	rent
pc	pcl	bmp	stop
p	p	bmp	potholder
tc	tcl	d	streetcar
kc	kcl	kg	clockwork
k	k	kg	cot
bc	bcl	bmp	bobtail
b	b	bmp	boat
dc	dcl	d	bloodclot
d	d	d	dock
gc	gcl	kg	game
g	g	kg	game	
d(	dx	d	ladder
t(	dx	d	batter
n(	nx	d	banter
f	f	f	fat
T	th	th	thing
s	s	z	sat
S	sh	sh	shut
v	v	f	vat
D	dh	th	that
z	z	z	zoo
Z	zh	z	azure
h	hh	h	head
tS	ch	sh	church
dZ	jh	sh	judge
m	m	bmp	met
n	n	d	net
N	ng	d	sing
l	NA	l	NA
l=	el	l	battle
m=	em	bmp	bottom
n=	en	bmp	button
.pau	.pau	_	pause
th	NA	th	NA
kh	NA	kg	NA
ph	NA	bmp	NA
dZc	dcl	j	(dZ closure)
tSc	tcl	sh	(tS closure)
d_\(	NA	d	??